1111111111111
1CC1CCCCCCCC1
1000011111001
100011E000001
1000000000001
1P00000000001
1111111111111